Player,Mat,"Wk Ct",St,"Wk Total",Active,"2022 Career Milestones"
"Dyll Davies",261,77,26,103,N,
"Chris Feeney",163,62,26,88,N,
"Tom Lockhart",165,71,15,86,Y,
"G Buckner",117,43,36,79,N,
"S Anaokar",129,55,15,70,N,
"Leon Parks",311,61,8,69,Y,
"Patrick Gledhill",129,42,14,56,Y,
"Suri Poleboina",76,42,7,49,Y,"<span class='achieved-milestone'>25 keeping catches</span>"
"Nicko Dowell",81,47,0,47,Y,"<span class='next-milestone'>50 keeping catches
(3 needed)</span>"
"Ben Hamilton",33,29,10,39,Y,"<span class='achieved-milestone'>25 keeping catches</span>"
"Richard Buckley",211,22,12,34,Y,"<span class='next-milestone'>25 keeping catches
(3 needed)</span>"
"R Richardson",30,15,9,24,N,
"Yanni Baveas",36,18,1,19,Y,
"Freddie Mills",118,17,1,18,Y,
"Kesh Wanigasekara",24,11,7,18,N,
"Chris Ovens",69,12,1,13,N,
"Grant Wolledge",148,9,2,11,Y,
"Ben Fletcher",11,6,5,11,Y,
"Tom Parrish",24,7,2,9,N,
"M Lachmann",14,5,3,8,N,
"Michael Ainslie",14,6,1,7,Y,
"Max Wright",22,6,0,6,Y,
"Robert Mead",8,4,0,4,Y,
"Arvind Kumar",140,3,0,3,N,
"Fred Gumpert",24,3,0,3,Y,
"A Whale",18,3,0,3,N,
"D Murray",14,3,0,3,N,
"Ed Woolcock",5,3,0,3,N,
"Ajit Prasad",56,1,2,3,Y,
"Nick Ridgway",299,2,0,2,Y,
"Adam Barraclough",101,2,0,2,Y,
"Paul Hynes",90,2,0,2,Y,
"Robert Keogh",72,2,0,2,Y,
"Jo Hockings",31,2,0,2,Y,
"Gareth Shaw",19,2,0,2,N,
"Alex Gordon-Walker",6,2,0,2,Y,
"E Shelley",1,2,0,2,N,
"G Jones",1,2,0,2,N,
"T Oxenham",1,2,0,2,N,
"Charlie Evans",12,1,1,2,Y,
"Sandeep Kumar",8,1,1,2,N,
"N Paropkari",2,1,1,2,N,
"Matt Ridgway",269,1,0,1,N,
"S Houchin",146,1,0,1,N,
"Tom James",17,1,0,1,N,
"D Banger",14,1,0,1,N,
"Dave Risley",8,1,0,1,N,
"F Jagger",5,1,0,1,N,
"D Riley",3,1,0,1,N,
"M Crew",1,1,0,1,N,
"Rob Bentley",1,1,0,1,N,
