Player,Mat,"Wk Ct",St,"Wk Total",Active,"2021 Career Milestones"
"Dyll Davies",261,77,26,103,N,
"Chris Feeney",163,62,26,88,N,
"Tom Lockhart",165,71,15,86,Y,
"G Buckner",117,43,36,79,N,
"S Anaokar",129,55,15,70,N,
"Leon Parks",297,55,6,61,Y,"<span class='achieved-milestone'>50 keeping catches</span>"
"Patrick Gledhill",126,42,14,56,Y,
"Nicko Dowell",79,47,0,47,N,
"Richard Buckley",211,22,12,34,Y,"<span class='next-milestone'>25 keeping catches
(3 needed)</span>"
"Suri Poleboina",48,23,5,28,Y,"<span class='next-milestone'>25 keeping catches
(2 needed)</span>"
"Ben Hamilton",23,19,9,28,Y,
"R Richardson",30,15,9,24,N,
"Freddie Mills",115,17,1,18,Y,
"Kesh Wanigasekara",24,11,7,18,N,
"Chris Ovens",69,12,1,13,Y,
"Grant Wolledge",148,9,2,11,Y,
"Yanni Baveas",21,10,0,10,Y,
"Tom Parrish",24,7,2,9,N,
"M Lachmann",14,5,3,8,N,
"Arvind Kumar",140,3,0,3,N,
"Fred Gumpert",23,3,0,3,Y,
"A Whale",18,3,0,3,N,
"D Murray",14,3,0,3,N,
"Ed Woolcock",5,3,0,3,N,
"Nick Ridgway",298,2,0,2,Y,
"Adam Barraclough",97,2,0,2,Y,
"Paul Hynes",90,2,0,2,Y,
"Robert Keogh",64,2,0,2,Y,
"Gareth Shaw",19,2,0,2,N,
"E Shelley",1,2,0,2,N,
"G Jones",1,2,0,2,N,
"T Oxenham",1,2,0,2,N,
"Sandeep Kumar",8,1,1,2,N,
"N Paropkari",2,1,1,2,N,
"Matt Ridgway",269,1,0,1,N,
"S Houchin",146,1,0,1,N,
"Tom James",17,1,0,1,N,
"D Banger",14,1,0,1,N,
"Dave Risley",8,1,0,1,N,
"F Jagger",5,1,0,1,N,
"D Riley",3,1,0,1,N,
"M Crew",1,1,0,1,N,
"Rob Bentley",1,1,0,1,N,
